Threshold,TrainAUC,TestAUC,Test CM,Train CM,NoRain_NoCloud,NoRain_Cloud,Rain_NoCloud,Rain_Cloud,S0train,S1train,S0test,S1test
0,100.0,53.8,"[[6.8706e+03 4.7800e+01]
 [1.1600e+01 1.2000e+00]]","[[27673.6     0. ]
 [    0.     51.2]]",0,34592,0,64,23180,39,11412,25
2,100.0,53.6,"[[6.8694e+03 4.8600e+01]
 [1.1600e+01 1.2000e+00]]","[[27672.      0. ]
 [    0.     51.2]]",2,34590,0,64,23172,46,11418,18
4,100.0,53.6,"[[6.8724e+03 4.5600e+01]
 [1.1600e+01 1.2000e+00]]","[[27672.      0. ]
 [    0.     51.2]]",2,34590,0,64,23172,46,11418,18
6,100.0,53.6,"[[6.8638e+03 5.4200e+01]
 [1.1600e+01 1.2000e+00]]","[[27672.      0. ]
 [    0.     51.2]]",2,34590,0,64,23175,43,11415,21
8,100.0,53.6,"[[6.879e+03 3.900e+01]
 [1.160e+01 1.200e+00]]","[[27672.      0. ]
 [    0.     51.2]]",2,34590,0,64,23165,53,11425,11
10,100.0,53.6,"[[6.871e+03 4.700e+01]
 [1.160e+01 1.200e+00]]","[[27672.      0. ]
 [    0.     51.2]]",2,34590,0,64,23179,39,11411,25
12,100.0,53.6,"[[6.8716e+03 4.6400e+01]
 [1.1600e+01 1.2000e+00]]","[[27672.      0. ]
 [    0.     51.2]]",2,34590,0,64,23173,45,11417,19
14,100.0,53.6,"[[6.8798e+03 3.8200e+01]
 [1.1600e+01 1.2000e+00]]","[[27672.      0. ]
 [    0.     51.2]]",2,34590,0,64,23180,38,11410,26
16,100.0,53.6,"[[6.8674e+03 5.0600e+01]
 [1.1600e+01 1.2000e+00]]","[[27672.      0. ]
 [    0.     51.2]]",2,34590,0,64,23182,36,11408,28
18,100.0,53.8,"[[6.8654e+03 5.2400e+01]
 [1.1600e+01 1.2000e+00]]","[[27671.2     0. ]
 [    0.     51.2]]",3,34589,0,64,23169,48,11420,16
20,100.0,54.0,"[[6.8696e+03 4.8200e+01]
 [1.1600e+01 1.2000e+00]]","[[27671.2     0. ]
 [    0.     51.2]]",3,34589,0,64,23177,40,11412,24
22,100.0,53.8,"[[6.8704e+03 4.7200e+01]
 [1.1600e+01 1.2000e+00]]","[[27670.4     0. ]
 [    0.     51.2]]",4,34588,0,64,23177,39,11411,25
24,100.0,53.8,"[[6.8706e+03 4.7000e+01]
 [1.1600e+01 1.2000e+00]]","[[27670.4     0. ]
 [    0.     51.2]]",4,34588,0,64,23173,43,11415,21
26,100.0,53.8,"[[6.87e+03 4.76e+01]
 [1.16e+01 1.20e+00]]","[[27670.4     0. ]
 [    0.     51.2]]",4,34588,0,64,23173,43,11415,21
28,100.0,53.8,"[[6.8628e+03 5.4800e+01]
 [1.1600e+01 1.2000e+00]]","[[27670.4     0. ]
 [    0.     51.2]]",4,34588,0,64,23175,41,11413,23
30,100.0,53.8,"[[6.8692e+03 4.8400e+01]
 [1.1600e+01 1.2000e+00]]","[[27670.4     0. ]
 [    0.     51.2]]",4,34588,0,64,23176,40,11412,24
32,100.0,53.8,"[[6.8692e+03 4.8400e+01]
 [1.1600e+01 1.2000e+00]]","[[27670.4     0. ]
 [    0.     51.2]]",4,34588,0,64,23175,41,11413,23
34,100.0,53.8,"[[6.8682e+03 4.9200e+01]
 [1.1600e+01 1.2000e+00]]","[[27669.6     0. ]
 [    0.     51.2]]",5,34587,0,64,23175,41,11412,23
36,100.0,53.8,"[[6.8756e+03 4.1800e+01]
 [1.1600e+01 1.2000e+00]]","[[27669.6     0. ]
 [    0.     51.2]]",5,34587,0,64,23176,40,11411,24
38,100.0,53.8,"[[6.8674e+03 5.0000e+01]
 [1.1600e+01 1.2000e+00]]","[[27669.6     0. ]
 [    0.     51.2]]",5,34587,0,64,23169,47,11418,17
40,100.0,53.8,"[[6.8788e+03 3.8600e+01]
 [1.1600e+01 1.2000e+00]]","[[27669.6     0. ]
 [    0.     51.2]]",5,34587,0,64,23170,46,11417,18
42,100.0,53.8,"[[6.8764e+03 4.1000e+01]
 [1.1600e+01 1.2000e+00]]","[[27669.6     0. ]
 [    0.     51.2]]",5,34587,0,64,23172,44,11415,20
44,100.0,53.8,"[[6.877e+03 4.040e+01]
 [1.160e+01 1.200e+00]]","[[27669.6     0. ]
 [    0.     51.2]]",5,34587,0,64,23175,41,11412,23
46,100.0,53.8,"[[6.879e+03 3.840e+01]
 [1.160e+01 1.200e+00]]","[[27669.6     0. ]
 [    0.     51.2]]",5,34587,0,64,23178,38,11409,26
48,100.0,53.0,"[[6.8706e+03 4.6800e+01]
 [1.1800e+01 1.0000e+00]]","[[27669.6     0. ]
 [    0.     51.2]]",5,34587,0,64,23170,46,11417,18
50,100.0,53.0,"[[6.8746e+03 4.2800e+01]
 [1.1800e+01 1.0000e+00]]","[[27669.6     0. ]
 [    0.     51.2]]",5,34587,0,64,23171,45,11416,19
52,100.0,53.8,"[[6.8686e+03 4.7200e+01]
 [1.1600e+01 1.2000e+00]]","[[27663.2     0. ]
 [    0.     51.2]]",13,34579,0,64,23165,45,11414,19
54,100.0,53.2,"[[6.6708e+03 4.2200e+01]
 [1.1800e+01 1.0000e+00]]","[[26852.      0. ]
 [    0.     51.2]]",1027,33565,0,64,22492,39,11073,25
56,100.0,52.6,"[[4.9246e+03 4.8600e+01]
 [1.1600e+01 1.0000e+00]]","[[19892.8     0. ]
 [    0.     50.4]]",9726,24866,1,63,16668,34,8198,29
58,100.0,51.0,"[[2.3166e+03 6.6800e+01]
 [1.0400e+01 6.0000e-01]]","[[9533.6    0. ]
 [   0.    44. ]]",22675,11917,9,55,7987,34,3930,21
60,100.0,69.2,"[[707.   49.8]
 [  3.8   3.2]]","[[3027.2    0. ]
 [   0.    28. ]]",30808,3784,29,35,2533,25,1251,10
62,100.0,65.8,"[[467.8  40. ]
 [  3.2   2.2]]","[[2031.2    0. ]
 [   0.    21.6]]",32053,2539,37,27,1696,23,843,4
64,100.0,54.0,"[[371.6  37.8]
 [  3.6   0.8]]","[[1637.6    0. ]
 [   0.    17.6]]",32545,2047,42,22,1371,15,676,7
66,100.0,61.0,"[[303.   35. ]
 [  2.    0.8]]","[[1352.     0. ]
 [   0.    11.2]]",32902,1690,50,14,1128,13,562,1
68,100.0,62.0,"[[266.2   5.4]
 [  1.6   0.6]]","[[1086.4    0. ]
 [   0.     8.8]]",33234,1358,53,11,909,8,449,3
70,100.0,67.0,"[[207.8  11.4]
 [  1.2   0.8]]","[[876.8   0. ]
 [  0.    8. ]]",33496,1096,54,10,734,7,362,3
72,100.0,73.6,"[[171.4   4.4]
 [  1.    1. ]]","[[703.2   0. ]
 [  0.    8. ]]",33713,879,54,10,588,7,291,3
74,100.0,64.0,"[[143.    2.2]
 [  1.2   0.6]]","[[580.8   0. ]
 [  0.    7.2]]",33866,726,55,9,485,7,241,2
76,100.0,47.6,"[[109.6   5. ]
 [  1.4   0. ]]","[[458.4   0. ]
 [  0.    5.6]]",34019,573,57,7,383,5,190,2
78,100.0,59.4,"[[90.8  0.6]
 [ 1.   0.2]]","[[365.6   0. ]
 [  0.    4.8]]",34135,457,58,6,305,5,152,1
