Threshold,TrainAUC,TestAUC,Test CM,Train CM,NoRain_NoCloud,NoRain_Cloud,Rain_NoCloud,Rain_Cloud,S0train,S1train,S0test,S1test
0,80.0,71.6,"[[4.4398e+03 2.4798e+03]
 [2.4000e+00 9.2000e+00]]","[[1.69766e+04 1.07018e+04]
 [2.00000e-01 4.62000e+01]]",0,34598,0,58,23182,37,11416,21
2,80.0,71.6,"[[4.4046e+03 2.4812e+03]
 [2.4000e+00 9.2000e+00]]","[[1.68564e+04 1.06868e+04]
 [2.00000e-01 4.62000e+01]]",169,34429,0,58,23068,38,11361,20
4,79.8,73.4,"[[4.312e+03 2.442e+03]
 [1.800e+00 9.800e+00]]","[[16385.8 10630.2]
 [    0.     46.4]]",828,33770,0,58,22621,43,11149,15
6,79.6,70.8,"[[4.1090e+03 2.4386e+03]
 [2.4000e+00 9.2000e+00]]","[[1.57858e+04 1.04046e+04]
 [2.00000e-01 4.62000e+01]]",1860,32738,0,58,21933,40,10805,18
8,79.0,70.0,"[[3.7932e+03 2.4146e+03]
 [2.4000e+00 9.2000e+00]]","[[1.47074e+04 1.01238e+04]
 [2.00000e-01 4.62000e+01]]",3559,31039,0,58,20797,37,10242,21
10,78.2,69.2,"[[3.3808e+03 2.3358e+03]
 [2.4000e+00 9.2000e+00]]","[[1.31586e+04 9.70780e+03]
 [2.00000e-01 4.62000e+01]]",6015,28583,0,58,19146,43,9437,15
12,77.8,68.6,"[[2.9720e+03 2.1336e+03]
 [2.4000e+00 9.2000e+00]]","[[1.16182e+04 8.80420e+03]
 [2.00000e-01 4.62000e+01]]",9070,25528,0,58,17104,38,8424,20
14,78.8,67.0,"[[2.4264e+03 1.6896e+03]
 [2.2000e+00 7.6000e+00]]","[[9667.8 6796.2]
 [   0.    39.2]]",14018,20580,9,49,13785,36,6795,13
16,82.0,61.6,"[[1917.  1102.6]
 [   3.4    5. ]]","[[8.5728e+03 3.5056e+03]
 [2.0000e+00 3.1600e+01]]",19500,15098,16,42,10116,27,4982,15
18,82.6,62.6,"[[1388.6  716.2]
 [   3.4    5. ]]","[[6.1094e+03 2.3098e+03]
 [2.0000e+00 3.1600e+01]]",24074,10524,16,42,7055,24,3469,18
20,80.8,62.8,"[[858.  480.6]
 [  3.    4.6]]","[[3.7266e+03 1.6278e+03]
 [2.0000e+00 2.8400e+01]]",27905,6693,20,38,4483,26,2210,12
22,79.8,65.8,"[[526.4 362.2]
 [  1.6   4.6]]","[[2.4612e+03 1.0932e+03]
 [2.2000e+00 2.2600e+01]]",30155,4443,27,31,2976,21,1467,10
24,84.4,72.0,"[[480.2 225. ]
 [  1.2   4.2]]","[[2.101e+03 7.198e+02]
 [1.000e+00 2.060e+01]]",31072,3526,31,27,2359,21,1167,6
26,85.4,62.6,"[[432.8 182. ]
 [  2.4   2.8]]","[[1.8772e+03 5.8200e+02]
 [1.0000e+00 1.9800e+01]]",31524,3074,32,26,2059,18,1015,8
28,84.4,72.0,"[[366.8 163.8]
 [  1.2   4. ]]","[[1.5876e+03 5.3480e+02]
 [1.0000e+00 1.9800e+01]]",31945,2653,32,26,1777,17,876,9
30,86.6,73.0,"[[385.6  78. ]
 [  1.8   3.2]]","[[1620.2  234.2]
 [   2.6   17.4]]",32280,2318,33,25,1555,14,763,11
32,86.4,71.0,"[[339.   70.2]
 [  2.    3. ]]","[[1422.2  214.6]
 [   2.6   17.4]]",32552,2046,33,25,1374,13,672,12
34,85.4,72.4,"[[299.8  68. ]
 [  1.8   3.2]]","[[1276.8  194.4]
 [   3.    17. ]]",32759,1839,33,25,1232,16,607,9
36,85.8,72.6,"[[262.8  59.8]
 [  1.8   3.2]]","[[1110.   180.4]
 [   2.8   17.2]]",32985,1613,33,25,1081,16,532,9
38,86.0,71.6,"[[227.2  56. ]
 [  1.6   3.2]]","[[968.  164.8]
 [  2.4  16.8]]",33182,1416,34,24,950,14,466,10
40,86.8,62.6,"[[202.   46.6]
 [  2.2   1.8]]","[[834.  160.4]
 [  1.6  14.4]]",33355,1243,38,20,831,15,412,5
42,86.8,77.4,"[[159.8  50. ]
 [  0.6   1.8]]","[[626.6 212.6]
 [  0.    9.6]]",33549,1049,46,12,703,7,346,5
44,86.0,80.0,"[[135.2  46.8]
 [  0.4   1.8]]","[[534.  194. ]
 [  0.    8.8]]",33688,910,47,11,610,7,300,4
46,84.6,56.4,"[[116.   41.2]
 [  1.    0.6]]","[[4.618e+02 1.670e+02]
 [2.000e-01 6.200e+00]]",33812,786,50,8,524,7,262,1
48,94.4,84.0,"[[118.4  15.6]
 [  0.2   0.8]]","[[480.6  55.4]
 [  0.    4. ]]",33928,670,53,5,448,4,222,1
50,0.0,0.0,"[[0, 0], [0, 0]]","[[0, 0], [0, 0]]",34012,586,58,0,392,0,194,0
52,0.0,0.0,"[[0, 0], [0, 0]]","[[0, 0], [0, 0]]",34082,516,58,0,345,0,171,0
54,0.0,0.0,"[[0, 0], [0, 0]]","[[0, 0], [0, 0]]",34136,462,58,0,309,0,153,0
56,0.0,0.0,"[[0, 0], [0, 0]]","[[0, 0], [0, 0]]",34207,391,58,0,261,0,130,0
58,0.0,0.0,"[[0, 0], [0, 0]]","[[0, 0], [0, 0]]",34274,324,58,0,217,0,107,0
60,0.0,0.0,"[[0, 0], [0, 0]]","[[0, 0], [0, 0]]",34345,253,58,0,169,0,84,0
62,0.0,0.0,"[[0, 0], [0, 0]]","[[0, 0], [0, 0]]",34402,196,58,0,131,0,65,0
64,0.0,0.0,"[[0, 0], [0, 0]]","[[0, 0], [0, 0]]",34444,154,58,0,103,0,51,0
66,0.0,0.0,"[[0, 0], [0, 0]]","[[0, 0], [0, 0]]",34460,138,58,0,92,0,46,0
68,0.0,0.0,"[[0, 0], [0, 0]]","[[0, 0], [0, 0]]",34482,116,58,0,77,0,39,0
70,0.0,0.0,"[[0, 0], [0, 0]]","[[0, 0], [0, 0]]",34498,100,58,0,67,0,33,0
72,0.0,0.0,"[[0, 0], [0, 0]]","[[0, 0], [0, 0]]",34506,92,58,0,61,0,31,0
74,0.0,0.0,"[[0, 0], [0, 0]]","[[0, 0], [0, 0]]",34511,87,58,0,58,0,29,0
76,0.0,0.0,"[[0, 0], [0, 0]]","[[0, 0], [0, 0]]",34514,84,58,0,56,0,28,0
78,0.0,0.0,"[[0, 0], [0, 0]]","[[0, 0], [0, 0]]",34517,81,58,0,54,0,27,0
